XXXXXXXXXXXXXXXXXXXXXXXXXXXXXXXXXXXXXXXXXXXXXXXXXXXXXXXXXXXXXXXX
X                                                              X
X                                                              X
X                                                              X
X                                                              X
X                                                              X
X                                                              X
X                                                              X
X                                                              X
X                                                              X
X                           XXXXXXXXX                          X
X                                                              X
X                                                              X
X                           XXXXXXXXX                          X
X                                                              X
X                                                              X
X                                                              X
X                           XXXXXXXXX                          X
X                                                              X
X                                                              X
X                           XXXXXXXXX                          X
X                                                              X
X                                                              X
X                                                              X
X                                                              X
X                                                              X
X                                                              X
X                                                              X
X                                                              X
X                                                              X
X                                                              X
XXXXXXXXXXXXXXXXXXXXXXXXXXXXXXXXXXXXXXXXXXXXXXXXXXXXXXXXXXXXXXXX
